---------------------------------------------------
--------------------------------------------------
--------------------------------------------------
--------------------------------------------------
--------------------------------------------------
--------------------------------------------------
--------------------------------------------------
----WWWW---------------WWWW---------------WWWW----
----WWWW---------------WWWW---------------WWWW----
----WWWW---------------WWWW---------------WWWW----
----WWWW---------------WWWW---------------WWWW----
--------------------------------------------------
--------------------------------------------------
--------------------------------------------------
--------------------------------------------------
--------------------------------------------------
--------------------------------------------------
----WWWW----------------------------------WWWW----
----WWWW------------WWWWWWWWWW------------WWWW----
----WWWW------------WWWWWWWWWW------------WWWW----
----WWWW------------WWWWWWWWWW------------WWWW----
--------------------WWWWWWWWWW--------------------
--------------------WW------WW--------------------
--------------------WW------WW--------------------
--------------------WW------WW--------------------
--------------------WW------WW--------------------
--------------------------------------------------
----WWWW----------------------------------WWWW----
----WWWW----------------------------------WWWW----
----WWWW----------------------------------WWWW----
----WWWW----------------------------------WWWW----
--------------------------------------------------
--------------------------------------------------
--------------------------------------------------
--------------------------------------------------
--------------------------------------------------
--------------------------------------------------
----WWWW----------------------------------WWWW----
----WWWW----------------------------------WWWW----
----WWWW----------------------------------WWWW----
----WWWW----------------------------------WWWW----
--------------------------------------------------
--------------------------------------------------
--------------------------------------------------
--------------------------------------------------
--------------------------------------------------
--------------------------------------------------