WWWWWWWW
WWWWWWWW
WWWWWWWW
WW----WW
WW----WW
WW----WW
--------
--------
--------
--------
--------
--------